header: cabeçalho do site
main: conteúdo principal
section: seção
article: artigo
aside: conteúdo periférico
footer: roda-pé
div: divisão block
span: divisão inline
id: nomear uma tag
class: classificar tags

h1: hierarquia de texto
h2: hierarquia de texto
h3: hierarquia de texto
h4: hierarquia de texto
h5: hierarquia de texto
hr: linha horizontal
p: parágrafo
br: quebrar linha
lorem: descrição aleatória
img: imagem
link:favicon: favicon
strong: negrito
em: itálico
mark: marcado
big: texto grande
small: texto pequeno
del: texto deletado (riscado)
ins: texto inserido (sublinhado)
sup: texto sobrescrito (x20)
sub: texto subscrito (H2O)
code: código/pré-formatação (document.getElementById('teste'))
q: citações
blockquote: citações completas
abbr: abreviações
bdo: texto invertido (tipos: rtl e ltr)
ol: lista numerada (tipos: a, A, 1 e I)
ul: lista não numerada (tipos: disc, circle e square)
il: item da lista
a: âncora de redireccionamiento de link externo (target=” (_blank, _self)” rel=”(external, nofollow, next, prev)”)
a: âncora de download de arquivo (download="(nome do arquivo.extensão)")
picture: várias imagens em só um anexo
source:media:type: definir escala para midia dinâmica















